XXXXXXXXXXXXXXXXXXXXXXXXXXXXXXXXXXXX
XW                X               GX
XSSSSSSSSSSSSSSSSSSSSBSSSSSSSSSSS  X
X               G                S X
X SSSSSSSSSSSSSSSSSSSSSSSSSSSSSS S X
X S G                         GS SHX
X S SSSSSSSSSSSSSSSSSSSSSSSSSS S S X
X S S                        S S S X
X S S SSSSSSSSSSSSSSSSSSSSSS S S S X
X S S S  G                 S S S S X
X S S S SSSSBSSSSSSSSSSSSS S G S S X
X S S S S   G            S S S S B X
X S S S S SSSSSSSSSSSSSS S S S S SGX
X B S S S S            S SGS S S S X
X SGS S BGS SSSSSSSSGB S S S S S S X
X S S B S S S        S S S S S S S X
X S S S S S S S  E   S S S S S S S X
X S S S S S S SSSSSSSS S S S S S S X
X S S S S S S G        S S S S S S X
X G S S S S SSSSSSSSSSBS S S SGS S X
X S S S S S G G G G      S S B S S X
X S S S S BBBBBBBSBSBBSSSS S S S S X
X S S S S         G        S S S S X
X S S S SSSSSSSSSSSSSSSSSSSS S G S X
X S S S                    G S S S X
X S S SSSSSSSSSSSSSSSSS S S  S S B X
X S S  B  B B G B    S SGS SGS S S X
X S S   B    G     B           S S X
X B GSSSSSSSSSSSSSSSBSSSSSSSSSSG S X
X S                              S X
X SSSSSSSSSSSSSSSSSSBSSSSSSSSSSSSS X
X          G                       X
XXXXXXXXXXXXXXXXXXXXXXXXXXXXXXXXXXXX